                                
   ------------                 
   |........^.|                 
   |....@.....+#######          
   |..!.......|      #          
   ------------      #####      
                     #          
   -------           #          
   |....)|    -------+------    
   |.....|    |...........]|    
   |.....+####+............|    
   ---+---    |....:.......|    
      #       |.........?..|    
      #       ------------+-    
      ################### #     
.#%+^@*)]:?/=!          ###     